####.#.###.#.#..
#.##...#######.#
.###.###..#.##..
#.##...#.#...###
....#.####..##..
..#.#.##..##..##
.##.....#...#...
..#.##..##......
.#..#.#..#.##.#.
#.###.##.#.#.#.#
####.###.##..#.#
.###..#....#...#
#.###.#######.#.
.####.#.#.##.##.
#.....##.#..###.
###.#.#.##..###.
