.#.#......#.#..#
.#.....##.#..#..
.#.###.#..#.....
.......###...#..
..#....#.#....#.
#............#..
#..........#....
....#........#..
.#....#.........
#.....#...#...#.
.#...#.......#..
##.....#.#....#.
......##........
..#.#......##...
................
.#.......#......
