.#.#####.#...###
.##...##.###.###
.#...#....#..###
...##.......#.##
#.##.##..####.#.
......##..#...##
##..###.#.#.#.##
#.###.#####.#...
###...#...#.##..
......#..##.#.##
.#...#.##....#..
...#...#...#..##
.##.....#.##..#.
SSSSSSSSSSSSSSSS
SSSSSSSSSSSSSSSS
SSSSSSSSSSSSSSSS
