.####...#....#.#
.##.....#..##..#
#.#..#..#.#.##..
####.....##..##.
.##.###.#.#..###
..#.##.##.###..#
#...#..#.#.#####
#.##....#..###..
###..#######.###
..#.#....#.#..#.
...###.###.##.#.
.#..#.#..#....##
##.#...#####...#
SSSSSSSSSSSSSSSS
SSSSSSSSSSSSSSSS
SSSSSSSSSSSSSSSS
